111111111111
1E00000h0001
1111111011C1
101000H00111
1000101100C1
1V1110111111
101C00100001
101111101101
1000000010P1
111111111111