111111111111
10E1v101v001
10110C010101
1H00010C0101
11C101V10101
111111111101
110v0C0v0C01
1P0000000001
110C0V0C0V01
111111111111